   
      
NO ./path_to_the_north_texture1  

SO ./path_to_the_south_texture2

WE ./path_to_the_                 west_texture3
EA ./path_to_the_east_texture4

F 220,100,0
C 225,30,0



     



                   


                        

111111111111
111110011111   
11110011111111
11110000001011
11111111000000111111
1111000001110000111111
1111000011100000000001
    1111101111111100011111
111110111111110000011111
11111011111000000000111
11111011111000000001111
1111100000000000011111
1111101111011111011111
11111111111111111110111
                 1111111       
