   
      
NO ./path_to_the_north_texture1  

SO ./path_to_the_south_texture2

WE ./path_to_the_west_texture3
EA ./path_to_the_east_texture4

F 220,100,0
C 225,30,0



     




111111
1000001
1111001111
   11011
   111111111   