NO ./textures/tx2.png
SO ./textures/tx2.png
WE ./textures/tx2.png
EA ./textures/tx2.png

F 220,100,0
C 225,30,0



     



                   


                        
   1111111111111
11111000011111   
1110000111111
1110000N01011
110000000000111111
111000000000111111
1111000011100000001
    1011110111111111111
111110111111110000011111
11111011111000000000111
11111011111000000001111
1111100000000000011111
1111101111011111011111
1111 1111111111111110111
                 1111111