NO ./textures/tx1.png
SO ./textures/tx1.png
WE ./textures/tx1.png
EA ./textures/tx1.png

F 16, 16, 33, 255
C 135, 206 , 235



     



                   


                        
   1111111111111
11111000011111   
1110000111111
1110000S01011
110000000000111111
111000000000111111
1111000011100000001
    1011110111111111111
111110111111110000011111
11111011111000000000111
11111011111000000001111
1111100000000000011111
1111101111011111011111
1111 1111111111111110111
                 1111111