NO ./textures/tx1.png
SO ./textures/tx1.png
WE ./textures/tx1.png
EA ./textures/tx1.png

F 16, 16, 33, 255
C 135, 206 , 235



     



11111111