NO textures/tx_1.png
SO textures/tx_2.png
WE textures/tx_3.png
EA textures/tx_4.png

F 16, 16, 255
C 135, 206 , 235



        111111111111111111111111111
1111111110000000000000000001       
10000001111111111111111111011
10000000000000000000000000011
10000001111111111111111111111
11110111111111111111111111111111
10000000000000000000000000001
11011111111011111111111111101
11000001111011111111111111101
11111101111011111111111111101
11111101111011111111111111101
11111101111000000000000000001
11111101111011111111111111111
10000000000011111111111111111
11111111111011111111111111111
11111111111000000000000000001
11111111111101111111111111011
11111111111101111111111111011
1000E000000000000000000000001
11111111111111111111111111111