NO ./textures/tx_1.png
SO ./textures/tx_2.png
WE ./textures/tx_1.png
EA ./textures/tx_2.png

F 16, 16, 33, 255
C 135, 206 , 235


          
1111111111111111111111
1000000000000000000001
1000000000000000000001
1000001D1000011D100001
1000000000011100000001
111111111D111111111111
1000000000000000000001
1000000000000000000001
1000000000000000000001
1000000000000000000001
1N00000000000000000001
1111111111111111111111