NO ./textures/tx2.png
SO ./textures/tx2.png
WE ./textures/tx2.png
EA ./textures/tx2.png

F 115, 147, 179, 255
C 54, 69, 79, 255


          
  111111111111111
11111000000000001111   
11100000000000001111
111000000000001011
110000000000111111
111000000000111111
11100000000000001
  1110000000001111111
1111100000000000011111
1100000000000000000011
1111100000000000001111
11111000W0000000011111
1111101111011111011111
111111111111111111110111
                 1111111