NO ./textures/tx1.png
SO ./textures/tx1.png
WE ./textures/tx1.png
EA ./textures/tx1.png

F 115, 147, 179, 255
C 54, 69, 79, 255


          
1111111111111111111111
1000000000000000000001
1000000000000000000001
1000000000000000000001
1000000000000000000001
111111111D111111111111
1000000000000000000001
1000000000000000000001
1000000000000000000001
1000000000000000000001
100000000N000000000001
1111111111111111111111