NO ./textures/tx_1.png
SO ./textures/tx_2.png
WE ./textures/tx_1.png
EA ./textures/tx_2.png

F 16, 16, 33, 255
C 135, 206 , 235






11111
11111
11111